 WE                            textures/wood.xpm
       NO      textures/redbrick.xpm



SO textures/greystone.xpm

F      17,    38,     64

EA textures/east.xpm



C 218, 234, 235

1111111111111111111111111
100011000010000000000000011111111
100011000000000011111100011111111
1000110000000000110001001
100000000E000000000001001
1111111111111111111111111