
 WE                            textures/wolfenstein/grey_stone.xpm
       NO      textures/wolfenstein/purple_stone.xpm



SO textures/wolfenstein/red_brick.xpm

F      17,    38,     64

EA textures/wolfenstein/wood.xpm



C 218, 234, 235

111111111
100000001
100000001
100000101
1N0000001
111111111